--------------------------------------------------------------------------------
--------------------------------------------------------------------------------
--------------------------------------------------------------------------------
--------------------------------------------------------------------------------
--------------------------------------------------------------------------------
--------------------------------------------------------------------------------
--------------------------------------------------------------------------------
--------------------------------------------------------------------------------
--------------------------------------------------------------------------------
--------------------------------------------------------------------------------
------------------#########################################---------------------
------------------#.......................................#---------------------
------------------#...###..#...#..........................#---------------------
------------------#....#...#...#..........................#---------------------
------------------#....#...###.#..........................#---------------------
------------------#....#...###.#..........................#---------------------
------------------#.......................................#---------------------
------------------#.####.###.###.###..###..#..#..####.....#---------------------
------------------#.#..#.#.#.#...#....#.#..#..#..#..#.....#---------------------
------------------#.#..#.#.#.###.###..#.#..#..#..#..#.....#---------------------
------------------#.#..#.#.#.#.#.#...#####.#.##..#..#.....#---------------------
------------------#.#..#.###.###.###.#...#.##.#.##..#.....#---------------------
------------------#.......................................#---------------------
------------------#.......................................#---------------------
------------------#.......................................#---------------------
------------------#...................@...................#---------------------
------------------#########################################---------------------
--------------------------------------------------------------------------------
--------------------------------------------------------------------------------
--------------------------------------------------------------------------------
--------------------------------------------------------------------------------
--------------------------------------------------------------------------------
--------------------------------------------------------------------------------
--------------------------------------------------------------------------------
--------------------------------------------------------------------------------
--------------------------------------------------------------------------------
--------------------------------------------------------------------------------