--------------------------------------------------------------------------------
--------------------------------------------------------------------------------
--------------------------------------------------------------------------------
--------------------------------------------------------------------------------
--------------------------------------------------------------------------------
--------------------------------------------------------------------------------
--------------------------------------------------------------------------------
--------------------------------------------------------------------------------
--------------------------------------------------------------------------------
--------------------------------------------------------------------------------
------------------#########################################---------------------
------------------#.....................................!.#---------------------
------------------#......###########################......#---------------------
------------------#......#!....!......!.....!....!.#......#---------------------
------------------#......#.........................#......#---------------------
------------------#......#!...#################..!.#......#---------------------
------------------#......#....#...............#....#....!.#---------------------
------------------#......#!...#...............#..!.#......#---------------------
------------------#......#....#...............#....#......#---------------------
------------------#...........#.......@.....!....!.#....!.#---------------------
------------------#......#....#...............#....#......#---------------------
------------------#..!...#....#...............#....#......#---------------------
------------------#......#....#...............#....#....!.#---------------------
------------------#......#....#################....#......#---------------------
------------------#......#.........................#......#---------------------
------------------#..!...#.........................#....!.#---------------------
------------------#......###########################......#---------------------
------------------#..!........!......!........!.........!.#---------------------
------------------#########################################---------------------
--------------------------------------------------------------------------------
--------------------------------------------------------------------------------
--------------------------------------------------------------------------------
--------------------------------------------------------------------------------
--------------------------------------------------------------------------------
--------------------------------------------------------------------------------
--------------------------------------------------------------------------------
--------------------------------------------------------------------------------
--------------------------------------------------------------------------------
--------------------------------------------------------------------------------
