...###...##
..##.#.####
.##..#.#..#
#...@..#...
.........#.
#.#.#.#.#.#
...........
#.#.#.#.#.#
...........
...........
...........
###########