-----------------------------------------------------------------------------
-----------------------------------------------------------------------------
-----------------------------------------------------------------------------
-----------------------------------------------------------------------------
-----------------------------------------------------------------------------
-----------------------------------------------------------------------------
-----------------------------------------------------------------------------
-----------------------------------------------------------------------------
-----------------------------------------------------------------------------
-----------------------------------------------------------------------------
------------------#########################################------------------
------------------#..@........#........#.......#.....#....#------------------
------------------#....#......#....#...#.......#.....#....#------------------
------------------#...........#....#...#.......#..........#------------------
------------------#....#..............####.######.####..##------------------
------------------#....#.......................#.....#....#------------------
------------------#...........#..........................#------------------
------------------##...####.###....#.....#...#######...####------------------
------------------#..............#####....................#------------------
------------------#..#....!...............................#------------------
------------------####.....####........######...#####.#####------------------
------------------#.....#.....#........#.................#------------------
------------------#....#.#..#.....##......................#------------------
------------------#..............#..#......#######.......#------------------
------------------#...!......#........#.......#..........#------------------
------------------#...........#........#.......#..........#------------------
------------------#########################################------------------
-----------------------------------------------------------------------------
-----------------------------------------------------------------------------
-----------------------------------------------------------------------------
-----------------------------------------------------------------------------
-----------------------------------------------------------------------------
-----------------------------------------------------------------------------
-----------------------------------------------------------------------------
-----------------------------------------------------------------------------
-----------------------------------------------------------------------------
-----------------------------------------------------------------------------