--------------------------------------------------------------------------------
--------------------------------------------------------------------------------
--------------------------------------------------------------------------------
--------------------------------------------------------------------------------
--------------------------------------------------------------------------------
--------------------------------------------------------------------------------
--------------------------------------------------------------------------------
--------------------------------------------------------------------------------
--------------------------------------------------------------------------------
--------------------------------------------------------------------------------
------------------#########################################---------------------
------------------#!........#.............................#---------------------
------------------#.......................................#---------------------
------------------#.........#...................!.........#---------------------
------------------###########...........###################---------------------
------------------#.........#.............................#---------------------
------------------#.............................!.........#---------------------
------------------#.........#...........###################---------------------
------------------###########...................!.........#---------------------
------------------#.........#.............................#---------------------
------------------#.......................................#---------------------
------------------#.........#.............................#---------------------
------------------###########...........#....#....#....#+.#---------------------
------------------#..!......#...........#....#....#!...#..#---------------------
------------------#.....................#....#!...#....#..#---------------------
------------------#......!..#.........@.#!...#....#....#..#---------------------
------------------#########################################---------------------
--------------------------------------------------------------------------------
--------------------------------------------------------------------------------
--------------------------------------------------------------------------------
--------------------------------------------------------------------------------
--------------------------------------------------------------------------------
--------------------------------------------------------------------------------
--------------------------------------------------------------------------------
--------------------------------------------------------------------------------
--------------------------------------------------------------------------------
--------------------------------------------------------------------------------