--------------------------------------------------------------------------------
--------------------------------------------------------------------------------
--------------------------------------------------------------------------------
--------------------------------------------------------------------------------
--------------------------------------------------------------------------------
--------------------------------------------------------------------------------
--------------------------------------------------------------------------------
--------------------------------------------------------------------------------
--------------------------------------------------------------------------------
--------------------------------------------------------------------------------
------------------#########################################---------------------
------------------#...................!...................#---------------------
------------------#................................!......#---------------------
------------------#.........!.............................#---------------------
------------------#................................!......#---------------------
------------------#...................+...................#---------------------
------------------#.!.#####################################---------------------
------------------#...............####....................#---------------------
------------------#........!......####...!........!.......#---------------------
------------------#...............####....................#---------------------
------------------#############.!.####...##############...#---------------------
------------------#...........#..........#................#---------------------
------------------#.....!.....#.....+....#........!.......#---------------------
------------------#...........#..........#................#---------------------
------------------#...#####...############.!.##############---------------------
------------------#...#####..................#............#---------------------
------------------#...#####......!.....!.....#............#---------------------
------------------#.@.#####..................#............#---------------------
------------------#########################################---------------------
--------------------------------------------------------------------------------
--------------------------------------------------------------------------------
--------------------------------------------------------------------------------
--------------------------------------------------------------------------------
--------------------------------------------------------------------------------
--------------------------------------------------------------------------------
--------------------------------------------------------------------------------
--------------------------------------------------------------------------------
--------------------------------------------------------------------------------
--------------------------------------------------------------------------------