--------------------------------------------------------------------------------
--------------------------------------------------------------------------------
--------------------------------------------------------------------------------
--------------------------------------------------------------------------------
--------------------------------------------------------------------------------
--------------------------------------------------------------------------------
--------------------------------------------------------------------------------
--------------------------------------------------------------------------------
--------------------------------------------------------------------------------
--------------------------------------------------------------------------------
------------------#########################################---------------------
------------------#.....................................!.#---------------------
------------------#......###########################......#---------------------
------------------#......#!....!......!.....!....!.#......#---------------------
------------------#......#.........................#....!.#---------------------
------------------#......#!...#################..!.#......#---------------------
------------------#......#....#...............#....#....!.#---------------------
------------------#......#!...#.......!.......#..!.#......#---------------------
------------------#......#....#....!.....!....#....#......#---------------------
------------------#..!........#.!.....@.....!....!.#....!.#---------------------
------------------#......#....#....!.....!....#....#......#---------------------
------------------#..!...#....#.......!.......#....#......#---------------------
------------------#......#....#...............#....#....!.#---------------------
------------------#..!...#....#################....#......#---------------------
------------------#......#.........................#......#---------------------
------------------#..!...#.........................#....!.#---------------------
------------------#......###########################......#---------------------
------------------#..!........!......!........!.........!.#---------------------
------------------#########################################---------------------
--------------------------------------------------------------------------------
--------------------------------------------------------------------------------
--------------------------------------------------------------------------------
--------------------------------------------------------------------------------
--------------------------------------------------------------------------------
--------------------------------------------------------------------------------
--------------------------------------------------------------------------------
--------------------------------------------------------------------------------
--------------------------------------------------------------------------------
--------------------------------------------------------------------------------