-----------------------------------------------------------------------------
-----------------------------------------------------------------------------
-----------------------------------------------------------------------------
-----------------------------------------------------------------------------
-----------------------------------------------------------------------------
-----------------------------------------------------------------------------
-----------------------------------------------------------------------------
-----------------------------------------------------------------------------
-----------------------------------------------------------------------------
-----------------------------------------------------------------------------
------------------#########################################------------------
------------------#..@........#........#.......#.....#....#------------------
------------------#....#......#....#...#.......#.....#....#------------------
------------------#...........#....#...#.......#..........#------------------
------------------#....#.......!.......####.######.####..##------------------
------------------#....#.......................#.....#....#------------------
------------------#...........#.................!.........#------------------
------------------##...####.###....#.....#...#######...####------------------
------------------#..............#####....................#------------------
------------------#..#....!...............................#------------------
------------------####.....####........######...#####.#####------------------
------------------#.....#.....#........#..............!...#------------------
------------------#....#.#..#.....##......................#------------------
------------------#..............#..#...!...#######.......#------------------
------------------#...!.......#........#.......#..........#------------------
------------------#...........#........#.......#..........#------------------
------------------#########################################------------------
-----------------------------------------------------------------------------
-----------------------------------------------------------------------------
-----------------------------------------------------------------------------
-----------------------------------------------------------------------------
-----------------------------------------------------------------------------
-----------------------------------------------------------------------------
-----------------------------------------------------------------------------
-----------------------------------------------------------------------------
-----------------------------------------------------------------------------
-----------------------------------------------------------------------------