-----------------------------------------------------------------------------
-----------------------------------------------------------------------------
-----------------------------------------------------------------------------
-----------------------------------------------------------------------------
-----------------------------------------------------------------------------
-----------------------------------------------------------------------------
------------------#########################################------------------
------------------#..........#.........#.......#.....#....#------------------
------------------#....#.....#.........#.......#.....#....#------------------
------------------#..........#....#....#.......#..........#------------------
------------------#....#.........@.....####.######.####..##------------------
------------------#....#.......................#.....#....#------------------
------------------#..........#..#.#.#.#...................#------------------
------------------##..####.###..........#...#######....####------------------
------------------#..............####................#....#------------------
------------------####......####......####........##......#------------------
------------------#########################################------------------
-----------------------------------------------------------------------------
-----------------------------------------------------------------------------
-----------------------------------------------------------------------------
-----------------------------------------------------------------------------
-----------------------------------------------------------------------------
-----------------------------------------------------------------------------
-----------------------------------------------------------------------------
