--------------------------------------------------------------------------------
--------------------------------------------------------------------------------
--------------------------------------------------------------------------------
--------------------------------------------------------------------------------
--------------------------------------------------------------------------------
--------------------------------------------------------------------------------
--------------------------------------------------------------------------------
--------------------------------------------------------------------------------
--------------------------------------------------------------------------------
--------------------------------------------------------------------------------
------------------#########################################---------------------
------------------#.....................................!.#---------------------
------------------#......###########################......#---------------------
------------------#......#!....!............!....!.#......#---------------------
------------------#......#.........................#......#---------------------
------------------#......#....#################..+.#......#---------------------
------------------#......#....#...............#....#....!.#---------------------
------------------#......#!...#...............#....#......#---------------------
------------------#......#....#...............#....#......#---------------------
------------------#...........#.......@..........!.#....!.#---------------------
------------------#......#....#...............#....#......#---------------------
------------------#..!...#....#...............#....#......#---------------------
------------------#......#....#...............#....#....!.#---------------------
------------------#......#....#################....#......#---------------------
------------------#......#.........................#......#---------------------
------------------#..!...#.........................#....!.#---------------------
------------------#......###########################......#---------------------
------------------#...........!......!........!...........#---------------------
------------------#########################################---------------------
--------------------------------------------------------------------------------
--------------------------------------------------------------------------------
--------------------------------------------------------------------------------
--------------------------------------------------------------------------------
--------------------------------------------------------------------------------
--------------------------------------------------------------------------------
--------------------------------------------------------------------------------
--------------------------------------------------------------------------------
--------------------------------------------------------------------------------
--------------------------------------------------------------------------------
