-----------------------------------------------------------------------------
-----------------------------------------------------------------------------
-----------------------------------------------------------------------------
-----------------------------------------------------------------------------
-----------------------------------------------------------------------------
-----------------------------------------------------------------------------
-----------------------------------------------------------------------------
-----------------------------------------------------------------------------
-----------------------------------------------------------------------------
-----------------------------------------------------------------------------
------------------#########################################------------------
------------------#...........#........#.......#.....#....#------------------
------------------#....#......#....#...#.......#.....#....#------------------
------------------#...........#....#...#.......#..........#------------------
------------------#....#.........@.....####.######.####..##------------------
------------------#....#.......................#.....#....#------------------
------------------#...........#...........................#------------------
------------------##...####.###....#.....#...#######...####------------------
------------------#..............#####....................#------------------
------------------#..#....................................#------------------
------------------####.....####........######...#####.#####------------------
------------------#.....#.....#........#..................#------------------
------------------#....#.#..#.....##......................#------------------
------------------#..............#..#.......#######.......#------------------
------------------#...........#........#.......#..........#------------------
------------------#...........#........#.......#..........#------------------
------------------#########################################------------------
-----------------------------------------------------------------------------
-----------------------------------------------------------------------------
-----------------------------------------------------------------------------
-----------------------------------------------------------------------------
-----------------------------------------------------------------------------
-----------------------------------------------------------------------------
-----------------------------------------------------------------------------
-----------------------------------------------------------------------------
-----------------------------------------------------------------------------
-----------------------------------------------------------------------------